NO ./assets/north.xpm42
SO ./assets/south.xpm42
EA ./assets/east.xpm42
WE ./assets/west.xpm42

F 50,50,50
C 50,50,50

11111111111111111111111111111111
1000L0LL0L0LLL0L0LLL0LL0LLL00001
1000LLLL0LL0LLL0LLLLL0L00LL00001
1D1111111111111111111111111111D1
1K0LLLLLL000LL0000LL000L000LK0W1
1L0LL0L0L000LL0000LL000L000L0001
11111111111111111111111111111111