NO ./assets/key.xpm42
SO ./assets/key.xpm42
EA ./assets/key.xpm42
WE ./assets/key.xpm42

F 50,50,50
C 50,50,50

11111111111111111111111111111111
10000000000000000000000000000001
10000000000000000000000000000001
10000000100000000000000000100001
10000000100000000000000000100001
10000000000000000000000000100001
10000000111111111100000000100001
10000000000000000000000000100001
10000000000000000000000000000001
10000000000000000000000000000001
10000011111111110000000000000001
10000000000000000000000000000001
100000000000000000000000000000W1
11111111111111111111111111111111