NO ./assets/north.xpm42
SO ./assets/south.xpm42
EA ./assets/east.xpm42
WE ./assets/west.xpm42

F 50,50,50
C 50,50,50

111111111
100000001
100010001
1000000W1
111111111